NO ./path_to_the_north_texture

SO ./path_to_the_south_texture
WE  ./path_to_the_west_texture

EA      ./path_to_the_east_texture
F       255,255,255
C       255,0,255

        1111111111111111111111111
        1000000000110000000000011
        101100000111000001000001
        1101000000000000100000011
111111111011000001110000000000001
100000000011000001110111111111111
11110111111111011100000010001 
11110111111111011101010010001
110000001101S1011100000010001
10000000000000011000000100011
10000000000000001101010010001
110000011101010111110111100111
11110111 1110101 101111110001
11111111 1111111 111111111111
