    11111
11110010111
100000100001
11110000111
111111111111
